1111111111111
10C10000000C1
100001000C001
1P0C01EX00001
1101111101111
1101101000111
1101101111011
1100X01000011
1110001011111
1111101000X11
1111111111111
1111111111111