11111111111111111111111111111
1C00C0000C000C00C00000000C1C1
11111111011111111101011110101
100C10000100000000000X0000001
10111001010011111111111111101
1000000100001E000000000000001
10111111111111111111111111011
1010001000010XX00000100010CC1
100010001X00000000100010000C1
11111111111110111011111111111
11PX10001000101C0010001CCCXC1
100000100010000010001000X00C1
11111111111111111111111111111