111111111111111111111111111111
1E0000000000000C00000C00001101
1010000000000001011000000C0101
100000000000000000000000000001
1P0001000C01111001111100000001
1000010000010C0001000100000001
1010010000011110010001000C0001
101001000001000001000100001001
100001111001111001111100011001
1000000000000000000000000C0001
111111111111111111111111111111