111111111111111111111111111111
1E0000000000000C00000C00001101
1010000000000001011000000C0101
100000000000000000000000000001
1P0001001C00000100010000000001
1000010100000C0100010000000001
1010011000000001111100000C0001
101001010000000100010000001001
100001001000000100010000011001
1000000000000000000000000C0001
111111111111111111111111111111