111111111111111111
11111000000000C001
11111111E000001111
111110011111110001
1P0001101111001111
111111111111111111