111111111111111111111111111111111
1C000000011C00000000000000000C0E1
11100000011X0000000000000000X1001
1000000XC000000000000001110000001
100000111000000000000000000000001
1P0000000000000000C00000000000011
111111111111111111111111111111111
