111111111111
110011C11001
100011011001
100000000001
100000000001
1111000110C1
100000110E11
1000000000C1
1P0000000001
111111111111